XXXXXXXXXXXXXXX...XXXXXXXXXXXXXXXXXXXXXXXXXXXXXXXXXXX
T.@.........XXX...XXX...........XXX...............@.T
XXXXXXXXX...XXX...XXX..G..G..G..XXX...XXX...XXXXXXXXX
X.*...*...*.XXX...XXX...........XXX...XXX.*...*...*.X
X...XXXXX...XXX...XXXXXXXHHHXXXXXXX...XXX...XXXXX...X
X.*.XXXXX.*.XXX...XXX.....g.....XXX...XXX.*.XXXXX.*.X
X...XXXXX...XXX...XXX...XXXXX...XXX...XXX...XXXXX...X
X.*...*...*.XXX...XXX.*...P...*.XXX...XXX.*...*...*.X
X...XXXXX...XXX...XXX...XXXXX...XXX...XXX...XXXXX...X
X.*.XXXXX.*.XXX...XXX.*.X...X.*.XXX...XXX.*.XXXXX.*.X
X...XXXXX...XXX...XXX...XXXXX...XXX...XXX...XXXXX...X
X.*...*...*.XXX...XXX.*...@...*.XXX...XXX.*...*...*.X
X...XXXXX...XXX...XXX...XXXXX...XXX...XXX...XXXXX...X
X.*.XXXXX.*.XXX...XXX.*.X...X.*.XXX...XXX.*.XXXXX.*.X
X...XXXXX...XXX...XXX...XXXXX...XXX...XXX...XXXXX...X
X.*...*...*.XXX...XXX.*...?...*.XXX...XXX.*...*...*.X
X...XXXXX...XXX...XXX...XXXXX...XXX...XXX...XXXXX...X
X.*...*...*.XXX...XXX.*.X...X.*.XXX...XXX.*...*...*.X
XXXXXXXXX...XXXXXXXXX...XXXXX...XXX...XXX...XXXXXXXXX
T.@...................*...*...*.......XXX.........@.T
XXXXXXXXXXXXXXXXXXXXXXXXXXXXXXXXXXXXXXXXXXXXXXXXXXXXX
