XXXXXXXXXXXXXXXXXXXXXXXXXXXXXXXXXXXXXXXXXXXXXXXXXXXXX
T.@..*..*..*..*..*..*.X.G.G.G.X.*..*..*..*..*..*..@.T
X...XXX...XXX...XXX...XXXHHHXXX...XXX...XXX...XXX...X
T.*..*..*..*..*..*..*..*..g..*..*..*..*..*..*..*..*.T
X...XXX...XXX...XXX...XXX...XXX...XXX...XXX...XXX...X
T.*..*..*..*..*..*..*..*..*..*..*..*..*..*..*..*..*.T
X...XXX...XXX...XXX...XXX...XXX...XXX...XXX...XXX...X
T.*..*..*..*..*..*..*..*..*..*..*..*..*..*..*..*..*.T
X...XXX...XXX...XXX...XXX...XXX...XXX...XXX...XXX...X
T.*..*..*..*..*..*..*..*..?..*..*..*..*..*..*..*..*.T
X...XXX...XXX...XXX...XXX...XXX...XXX...XXX...XXX...X
T.*..*..*..*..*..*..*..*..*..*..*..*..*..*..*..*..*.T
X...XXX...XXX...XXX...XXX...XXX...XXX...XXX...XXX...X
T.*..*..*..*..*..*..*..*..*..*..*..*..*..*..*..*..*.T
X...XXX...XXX...XXX...XXX...XXX...XXX...XXX...XXX...X
T.*..*..*..*..*..*..*..*..*..*..*..*..*..*..*..*..*.T
X...XXX...XXX...XXX...XXX...XXX...XXX...XXX...XXX...X
T.*..*..*..*..*..*..*..*..*..*..*..*..*..*..*..*..*.T
X...XXX...XXX...XXX...XXX...XXX...XXX...XXX...XXX...X
T.@..*..*..*..*..*..*..*..P..*..*..*..*..*..*..*..@.T
XXXXXXXXXXXXXXXXXXXXXXXXXXXXXXXXXXXXXXXXXXXXXXXXXXXXX
