XXXXXXXXXXXXXXXXXXXXXXX.......XXXXXXXXXXXXXXXXXXXXXXX
X.@.X.*..*..*....*..*.X.......X.*..*....*..*..*.X.@.X
X.*.X...XXXXXXXX...XXXXXXXXXXXXXXX...XXXXXXXX...X.*.X
X.*..*..*..*.XXX.*..*..*..*..*..*..*.XXX.*..*..*..*.X
X.*.XXXXXXXXXXXXXXX...XXX...XXX...XXXXXXXXXXXXXXX.*.X
X.*.X.*...*..*...*..*.XXX...XXX.*..*...*..*...*.X.*.X
X.*.X...XXXX...XXXX...XXX...XXX...XXXX...XXXX...X.*.X
X.*...*..@.X.*.X.*........g........*.X.*.X.?..*...*.X
X.*.XXXXXXXX...XXX...XXXXHHHXXXX...XXX...XXXXXXXX.*.X
XXXXX.*...*..*........*.X.G.X.*........*..*...*.XXXXX
T.......XXXXXXXXXXXXXXXXX.G.XXXXXXXXXXXXXXXXX.......T
XXXXX.*..*..*..*...*..*.X.G.X.*..*...*..*..*..*.XXXXX
X.*.XXXXXXXXXX...X...XXXXXXXXXXX...X...XXXXXXXXXX.*.X
X.*...*..*..*..*.X.*.X.*..@..*.X.*.X.*..*..*..*...*.X
X.*.XXXX...XXXXXXX...XXXX...XXXX...XXXXXXX...XXXX.*.X
X.*.X.*..*....*....*.X.*..*..*.X.*....*....*..*.X.*.X
X.*.XXXXXXXXX...XXXXXXXXX...XXXXXXXXX...XXXXXXXXX.*.X
X.*..*..*..*..*..*..*..*..P..*..*..*..*..*..*..*..*.X
X.*.XXXX...XXXXXXXX...XXXXXXXXX...XXXXXXXX...XXXX.*.X
X.*.X.*..*..*..*....*.X.......X.*....*..*..*..*.X.*.X
XXXXXXXXXXXXXXXXXXXXXXX.......XXXXXXXXXXXXXXXXXXXXXXX
