.....................................................
.....................................................
.....................................................
.....................................................
.....................................................
.............XXXXXXXXXXXXXXXXXXXXXXXXXXXX............
.............XXXXXXXXXXXXXXXXXXXXXXXXXXXX............
.............XX.*******...g...*******.XXX............
XXXXXXXXXXXXXXX.*.XXX...XXHXX...XXX.*.XXXXXXXXXXXXXXX
T...*************.XXX.?.XGGGX.@.XXX.*************...T
XXXXXXXXXXXXXXX.*.XXX...XXXXX...XXX.*.XXXXXXXXXXXXXXX
............XXX.*******...P...*******.XXX............
............XXXXXXXXXXXXXXXXXXXXXXXXXXXXX............
............XXXXXXXXXXXXXXXXXXXXXXXXXXXXX............
.....................................................
.....................................................
.....................................................
.....................................................
.....................................................
.....................................................
.....................................................
